00 00 00 00 00 00 00 00 00 00 00 00 00 00 00 00 00 00 00 00
00 01 01 01 00 00 00 00 00 00 00 00 00 00 00 00 00 00 00 00
00 01 03 01 00 00 00 01 01 01 01 01 01 01 01 01 01 01 01 00
00 01 01 01 00 00 00 01 01 01 01 01 81 01 01 01 01 03 01 00
00 00 01 01 01 01 01 01 01 01 01 01 01 01 01 01 01 01 01 00
00 00 01 01 01 01 01 01 01 01 01 01 01 00 00 00 01 01 01 00
00 00 01 01 01 01 00 00 00 00 01 01 01 00 00 00 01 01 01 00
00 00 01 01 01 01 00 00 00 00 01 01 01 00 00 00 01 01 01 00
00 00 01 01 01 01 00 00 00 00 01 01 01 00 00 00 01 01 01 00
00 00 00 00 01 01 00 00 00 01 01 01 01 01 01 01 01 01 01 00
00 00 00 00 01 01 00 00 01 01 01 01 01 01 00 00 00 01 01 00
00 00 00 00 01 01 00 00 01 01 01 01 01 01 00 00 00 01 01 00
00 00 00 00 01 01 00 00 01 01 01 01 00 00 00 00 00 01 01 00
00 00 00 00 01 01 00 00 01 01 01 00 00 00 00 00 00 01 01 00
00 01 01 01 01 01 01 01 01 01 01 00 00 00 00 00 00 01 01 00
00 01 01 01 01 01 01 01 01 01 01 01 00 00 00 00 00 01 01 00
00 01 03 01 01 01 81 01 01 01 01 01 01 01 01 01 01 01 01 00
00 01 01 01 01 01 01 01 01 01 01 01 01 01 01 01 01 03 01 00
00 00 00 00 00 00 00 01 01 01 01 01 01 01 01 01 01 01 01 00
00 00 00 00 00 00 00 00 00 00 00 00 00 00 00 00 00 00 00 00